###########
#*********#
#*********#
#*********#
#*********#
#*********D
#*********#
#*********#
#*********#
#*********#
#####D#####
