#####D#####
#*********#
#*********#
#*********#
#*********#
#*********D
#*********#
#*********#
#*********#
#*********#
###########
