#####D#####
#*********#
#*********#
#*********#
#*********#
D*********#
#*********#
#*********#
#*********#
#*********#
###########
