#####D#####
#*********#
#*********#
#*********#
#*********#
D*********D
#*********#
#*********#
#*********#
#*********#
###########
