#####D#####
#*********#
#*********#
#*********#
#*********#
D*********#
#*********#
#*********#
#*********#
#*********#
#####D#####
